#,#,#,#,#,#,.,#,.,.,.$
#,.,#,.,.,#,.,#,#,#,#$
#,.,#,.,.,.,.,.,.,#,#$
#,.,#,.,.,#,#,#,#,#,#$
#,.,.,#,.,.,.,.,.,.,#$
#,.,.,.,#,.,#,#,.,.,#$
#,.,.,.,.,#,.,.,.,.,#$
#,.,.,.,.,#,.,.,.,.,#$
#,.,.,.,.,.,.,.,.,.,#$
#,#,#,#,#,#,#,#,#,.,#$
